id_cliente,cla_cliente,tot_orcamento,fat_cliente,des_orcamento,por_desconto,fec_orcamentos,rec_orcamentos
100,L,7290,7070,220,"00,03",2,9
101,J,6050,5980,70,"00,01",6,1
102,F,15210,14290,920,"00,06",5,6
103,F,11540,11300,240,"00,02",1,9
104,K,1900,1820,80,"00,04",6,6
105,D,13400,13260,140,"00,01",3,1
106,J,6340,6080,260,"00,04",6,1
107,E,12630,12500,130,"00,01",3,3
108,E,11430,10740,690,"00,06",7,7
109,J,2770,2630,140,"00,05",6,2
110,F,10910,10140,770,"00,07",1,10
111,D,10950,10510,440,"00,04",2,0
112,D,13000,12000,1000,"00,08",8,5
113,I,4370,4370,0,"00,00",2,10
114,D,10500,9970,530,"00,05",4,1
115,D,12840,12190,650,"00,05",10,4
116,J,5570,5230,340,"00,06",8,0
117,J,1730,1660,70,"00,04",10,3
118,J,2790,2670,120,"00,04",9,4
119,I,150,150,0,"00,00",1,7
120,J,6650,6250,400,"00,06",4,0
121,E,11000,10770,230,"00,02",6,6
122,J,1080,1050,30,"00,03",10,0
123,L,2970,2850,120,"00,04",8,10
124,F,11760,11280,480,"00,04",5,9
125,D,12920,12660,260,"00,02",6,0
126,J,1470,1420,50,"00,03",4,1
127,I,4020,4020,0,"00,00",3,9
128,D,9330,9230,100,"00,01",6,3
129,L,2170,2060,110,"00,05",2,5
130,L,5580,5240,340,"00,06",3,5
131,L,7560,7030,530,"00,07",1,10
132,D,12320,11450,870,"00,07",4,2
133,I,100,100,0,"00,00",1,5
134,L,6260,5940,320,"00,05",1,2
135,D,10460,10040,420,"00,04",4,2
136,D,14630,14040,590,"00,04",8,7
137,D,8280,8030,250,"00,03",7,6
138,J,6210,5960,250,"00,04",10,0
139,D,10220,10110,110,"00,01",9,6
140,F,12270,11410,860,"00,07",2,6
141,F,9350,8880,470,"00,05",1,8
142,J,4650,4410,240,"00,05",10,6
143,L,3450,3270,180,"00,05",3,7
144,F,13180,12380,800,"00,06",4,6
145,F,13140,12610,530,"00,04",4,6
146,F,14410,13540,870,"00,06",3,6
147,G,3910,3910,0,"00,00",5,3
148,J,2490,2410,80,"00,03",10,7
149,G,2180,2180,0,"00,00",5,2
150,L,3720,3680,40,"00,01",1,9
151,K,2650,2620,30,"00,01",9,9
152,F,9630,9240,390,"00,04",3,9
153,L,5380,5320,60,"00,01",8,10
154,J,3440,3330,110,"00,03",9,1
155,J,2190,2160,30,"00,01",7,1
156,F,13310,12460,850,"00,06",1,2
157,I,3500,3500,0,"00,00",5,7
158,J,6410,6150,260,"00,04",7,3
159,D,9610,9030,580,"00,06",9,2
160,L,5850,5490,360,"00,06",4,6
161,G,1750,1750,0,"00,00",9,4
162,F,11160,10710,450,"00,04",9,10
163,F,11660,11420,240,"00,02",1,2
164,F,9640,9060,580,"00,06",2,4
165,L,1370,1340,30,"00,02",5,8
166,D,10260,9840,420,"00,04",10,5
167,D,13600,13490,110,"00,01",3,1
168,F,13340,12530,810,"00,06",4,7
169,L,820,810,10,"00,01",3,10
170,F,10360,9730,630,"00,06",8,10
171,F,14080,13650,430,"00,03",7,8
172,J,3280,3110,170,"00,05",5,4
173,D,12500,12150,350,"00,03",8,7
174,L,1490,1440,50,"00,03",5,9
175,G,3270,3270,0,"00,00",7,1
176,F,11240,11010,230,"00,02",2,10
177,D,15650,14800,850,"00,05",10,8
178,J,1640,1550,90,"00,05",10,2
179,A,13840,13840,0,"00,00",10,6
180,L,5660,5540,120,"00,02",1,3
181,J,6140,5950,190,"00,03",6,3
182,F,10410,9680,730,"00,07",6,7
183,E,12330,11950,380,"00,03",10,10
184,D,8840,8220,620,"00,07",8,1
185,F,9260,8980,280,"00,03",3,7
186,D,10780,10020,760,"00,07",7,4
187,J,5330,5270,60,"00,01",5,2
188,L,4060,3970,90,"00,02",1,5
189,L,4390,4340,50,"00,01",1,10
190,J,5160,4790,370,"00,07",7,2
191,F,9860,9760,100,"00,01",3,6
192,F,12930,12280,650,"00,05",4,6
193,J,6810,6740,70,"00,01",8,2
194,F,13430,13020,410,"00,03",1,9
195,F,14700,14110,590,"00,04",8,9
196,J,4850,4650,200,"00,04",10,7
197,L,2760,2640,120,"00,04",5,7
198,D,14560,13540,1020,"00,07",9,8
199,L,2800,2680,120,"00,04",6,9
200,E,8780,8340,440,"00,05",6,6
201,A,12330,12330,0,"00,00",8,4
202,G,2440,2440,0,"00,00",6,3
203,I,4700,4700,0,"00,00",3,8
204,H,100,100,0,"00,00",1,1
205,J,3690,3650,40,"00,01",10,2
206,J,5640,5300,340,"00,06",10,3
207,D,13340,13070,270,"00,02",4,3
208,E,13390,12580,810,"00,06",7,7
209,E,8720,8370,350,"00,04",2,2
210,F,8270,7770,500,"00,06",1,5
211,J,6930,6650,280,"00,04",7,0
212,F,15500,14110,1390,"00,09",2,7
213,I,2380,2380,0,"00,00",1,7
214,J,6040,5850,190,"00,03",5,0
215,I,200,200,0,"00,00",1,8
216,J,3780,3700,80,"00,02",9,5
217,I,3540,3540,0,"00,00",6,7
218,J,7530,7070,460,"00,06",7,5
219,L,3510,3400,110,"00,03",2,3
220,D,14630,13890,740,"00,05",5,1
221,G,5980,5980,0,"00,00",5,3
222,D,13660,13380,280,"00,02",1,0
223,L,4120,4030,90,"00,02",3,6
224,D,13760,12790,970,"00,07",9,7
225,J,4680,4490,190,"00,04",6,2
226,D,14700,13670,1030,"00,07",5,3
227,K,7480,7180,300,"00,04",6,6
228,K,6380,6060,320,"00,05",3,3
229,L,5380,5320,60,"00,01",8,10
230,J,440,420,20,"00,05",4,2
231,J,3750,3670,80,"00,02",10,5
232,J,3630,3480,150,"00,04",7,6
233,L,950,940,10,"00,01",3,5
234,L,4520,4330,190,"00,04",8,9
235,C,12640,12640,0,"00,00",8,9
236,J,7170,6880,290,"00,04",8,4
237,D,15100,14340,760,"00,05",3,1
238,D,8420,7910,510,"00,06",7,6
239,L,550,540,10,"00,02",3,8
240,L,790,770,20,"00,03",3,10
241,L,3970,3810,160,"00,04",8,9
242,D,15730,14620,1110,"00,07",9,8
243,B,14220,14220,0,"00,00",4,4
244,K,710,700,10,"00,01",1,1
245,F,11570,10990,580,"00,05",9,10
246,L,2540,2410,130,"00,05",3,7
247,J,4720,4620,100,"00,02",5,1
248,L,5620,5500,120,"00,02",2,4
249,F,10880,10660,220,"00,02",5,7
250,D,7820,7660,160,"00,02",6,1
251,L,5350,5290,60,"00,01",8,9
252,J,5330,5270,60,"00,01",8,2
253,J,3260,3190,70,"00,02",8,2
254,D,12680,12290,390,"00,03",7,0
255,F,14340,13900,440,"00,03",5,7
256,L,2450,2320,130,"00,05",2,9
257,F,10650,10540,110,"00,01",6,8
258,L,3860,3660,200,"00,05",4,5
259,G,3740,3740,0,"00,00",10,2
260,L,4120,3990,130,"00,03",5,10
261,D,9070,8970,100,"00,01",8,4
262,D,13870,13590,280,"00,02",8,0
263,C,14720,14720,0,"00,00",1,10
264,F,14770,13730,1040,"00,07",3,8
265,J,4080,3950,130,"00,03",9,4
266,L,3260,3120,140,"00,04",5,10
267,L,920,910,10,"00,01",2,6
268,L,7280,7060,220,"00,03",2,3
269,J,1570,1530,40,"00,03",5,2
270,F,8920,8290,630,"00,07",6,8
271,J,1460,1440,20,"00,01",5,3
272,L,950,920,30,"00,03",3,5
273,L,820,800,20,"00,02",1,5
274,K,3230,3130,100,"00,03",6,6
275,F,12040,11910,130,"00,01",7,8
276,D,11210,10530,680,"00,06",4,1
277,F,12050,11320,730,"00,06",4,8
278,L,7630,7090,540,"00,07",7,9
279,J,6710,6440,270,"00,04",9,6
280,D,9810,9310,500,"00,05",7,2
281,D,14590,13710,880,"00,06",7,4
282,D,15860,14900,960,"00,06",8,2
283,D,11750,10920,830,"00,07",8,4
284,E,9440,8770,670,"00,07",4,4
285,K,1130,1100,30,"00,03",5,5
286,F,8090,7680,410,"00,05",3,6
287,K,4230,4060,170,"00,04",7,7
288,F,14090,13240,850,"00,06",1,6
289,F,9280,9090,190,"00,02",4,6
290,F,12270,11900,370,"00,03",2,3
291,F,13070,12800,270,"00,02",3,10
292,L,7680,7140,540,"00,07",1,5
293,D,9220,8660,560,"00,06",5,3
294,D,14090,12970,1120,"00,08",9,4
295,J,5340,5120,220,"00,04",3,0
296,F,15420,14640,780,"00,05",5,10
297,D,9450,9260,190,"00,02",4,1
298,F,9050,8410,640,"00,07",5,6
299,G,3830,3830,0,"00,00",9,8
300,D,11940,11340,600,"00,05",5,3
301,F,15790,15000,790,"00,05",8,10
302,J,5640,5300,340,"00,06",8,1
303,D,14690,14540,150,"00,01",10,2
304,D,11820,11110,710,"00,06",7,0
305,D,10700,10480,220,"00,02",10,3
306,D,8270,7930,340,"00,04",6,5
307,G,5180,5180,0,"00,00",9,6
308,D,10500,10340,160,"00,02",6,1
309,F,7800,7720,80,"00,01",1,5
310,D,10420,10000,420,"00,04",8,6
311,A,13310,13310,0,"00,00",9,0
312,L,4590,4490,100,"00,02",6,8
313,D,14750,14300,450,"00,03",9,6
314,F,11450,10760,690,"00,06",1,10
315,D,11870,11630,240,"00,02",6,5
316,J,6400,6050,350,"00,05",9,7
317,J,4570,4380,190,"00,04",6,1
318,L,4760,4560,200,"00,04",4,6
319,D,13870,13730,140,"00,01",4,1
320,J,6650,6580,70,"00,01",10,9
321,F,14070,13780,290,"00,02",1,4
322,E,12180,11320,860,"00,07",5,5
323,J,4580,4440,140,"00,03",3,2
324,L,4520,4380,140,"00,03",7,10
325,J,3820,3700,120,"00,03",7,1
326,F,15530,14440,1090,"00,07",4,6
327,L,3500,3460,40,"00,01",3,8
328,D,11910,11310,600,"00,05",8,2
329,F,8570,8480,90,"00,01",6,9
330,F,11840,11240,600,"00,05",6,7
331,F,10940,10720,220,"00,02",1,2
332,F,15430,14500,930,"00,06",4,8
333,F,15630,15000,630,"00,04",1,5
334,J,5240,4920,320,"00,06",4,1
335,J,4930,4780,150,"00,03",9,7
336,J,2090,2020,70,"00,03",10,1
337,D,12740,12350,390,"00,03",7,5
338,L,720,690,30,"00,04",4,8
339,I,150,150,0,"00,00",1,3
340,J,7590,7130,460,"00,06",8,3
341,J,3220,3120,100,"00,03",2,1
342,D,11040,10370,670,"00,06",10,3
343,D,14680,13940,740,"00,05",7,0
344,D,8740,8120,620,"00,07",2,1
345,E,13560,13280,280,"00,02",1,1
346,D,9840,9540,300,"00,03",8,6
347,F,11060,10720,340,"00,03",3,9
348,J,5470,5250,220,"00,04",8,5
349,Z,0,0,0,"00,00",0,5
350,D,10130,10020,110,"00,01",2,1
351,D,13540,13400,140,"00,01",8,6
352,J,3430,3360,70,"00,02",9,4
353,L,4340,4200,140,"00,03",1,8
354,K,2530,2420,110,"00,04",2,2
355,D,15040,13980,1060,"00,07",6,3
356,L,5510,5120,390,"00,07",4,10
357,F,11340,10770,570,"00,05",7,8
358,D,9750,9160,590,"00,06",5,1
359,J,5210,5100,110,"00,02",9,4
360,J,2060,1970,90,"00,04",1,0
361,J,2970,2930,40,"00,01",5,1
362,J,2920,2860,60,"00,02",10,0
363,L,6630,6230,400,"00,06",2,6
364,D,11500,10660,840,"00,07",6,0
365,J,1350,1330,20,"00,01",6,5
366,F,8020,7610,410,"00,05",2,6
367,J,3750,3670,80,"00,02",6,4
368,L,5140,4830,310,"00,06",5,6
369,I,4870,4870,0,"00,00",2,5
370,J,7970,7490,480,"00,06",10,7
371,F,10560,10340,220,"00,02",4,6
372,F,11780,11420,360,"00,03",8,10
373,F,9840,9740,100,"00,01",6,7
374,F,10110,9800,310,"00,03",1,9
375,D,9950,9750,200,"00,02",9,1
376,D,14050,13060,990,"00,07",8,5
377,L,2230,2160,70,"00,03",4,10
378,D,12740,11840,900,"00,07",8,6
379,D,7670,7510,160,"00,02",9,2
380,F,12270,11650,620,"00,05",8,10
381,F,11400,11170,230,"00,02",2,3
382,J,1070,1030,40,"00,04",3,1
383,J,1220,1180,40,"00,03",9,3
384,D,12740,12100,640,"00,05",6,1
385,D,9300,9110,190,"00,02",10,7
386,J,870,840,30,"00,03",2,1
387,F,13940,13660,280,"00,02",4,8
388,F,15050,14290,760,"00,05",3,7
389,L,690,680,10,"00,01",4,9
390,F,10290,9980,310,"00,03",2,8
391,I,5790,5790,0,"00,00",2,4
392,D,8780,8510,270,"00,03",7,1
393,F,14590,13860,730,"00,05",4,5
394,J,4840,4500,340,"00,07",9,0
395,F,9690,9390,300,"00,03",2,7
396,J,6310,5930,380,"00,06",7,2
397,A,8310,8310,0,"00,00",6,1
398,F,9260,8880,380,"00,04",8,9
399,D,9050,8860,190,"00,02",10,2
400,F,10180,9670,510,"00,05",3,6
401,K,2030,1960,70,"00,03",8,8
402,F,10060,9450,610,"00,06",4,5
403,D,7930,7850,80,"00,01",3,1
404,D,12360,11740,620,"00,05",5,0
405,D,10670,10340,330,"00,03",5,3
406,F,9450,8730,720,"00,08",2,9
407,D,13890,13330,560,"00,04",8,4
408,F,13530,12580,950,"00,07",2,4
409,F,11970,11730,240,"00,02",6,7
410,L,7220,6710,510,"00,07",2,3
411,D,11250,11020,230,"00,02",2,1
412,D,12390,12010,380,"00,03",10,8
413,I,1350,1350,0,"00,00",3,6
414,L,3100,2970,130,"00,04",1,6
415,D,8030,7540,490,"00,06",8,5
416,J,7310,6790,520,"00,07",7,5
417,I,2320,2320,0,"00,00",3,6
418,F,8250,8080,170,"00,02",5,7
419,H,4880,4880,0,"00,00",9,9
420,E,7800,7560,240,"00,03",1,1
421,F,11860,11380,480,"00,04",1,9
422,D,10080,9470,610,"00,06",2,0
423,F,9000,8500,500,"00,06",4,5
424,D,9690,9100,590,"00,06",5,1
425,J,1160,1140,20,"00,02",10,9
426,J,1070,1040,30,"00,03",3,0
427,J,1770,1750,20,"00,01",8,7
428,E,10220,9870,350,"00,03",4,4
429,L,4340,4120,220,"00,05",1,4
430,D,8150,7570,580,"00,07",7,6
431,J,700,690,10,"00,01",6,1
432,K,3770,3690,80,"00,02",10,10
433,D,15460,14530,930,"00,06",5,0
434,D,10850,10090,760,"00,07",10,3
435,D,8530,8270,260,"00,03",7,6
436,D,9370,8990,380,"00,04",6,1
437,J,5420,5360,60,"00,01",10,2
438,J,590,580,10,"00,02",1,0
439,F,9900,9760,140,"00,01",3,4
440,D,13650,13370,280,"00,02",8,0
441,F,14710,14410,300,"00,02",9,10
442,J,4620,4480,140,"00,03",8,5
443,I,1760,1760,0,"00,00",7,10
444,J,4050,3960,90,"00,02",3,2
445,L,3980,3930,50,"00,01",1,9
446,J,560,550,10,"00,02",1,0
447,J,3620,3510,110,"00,03",9,0
448,F,12310,11690,620,"00,05",2,7
449,G,3860,3860,0,"00,00",9,6
450,J,2010,1900,110,"00,05",5,0
451,F,12300,11680,620,"00,05",2,5
452,F,10680,10140,540,"00,05",3,10
453,J,5350,5290,60,"00,01",7,0
454,J,1690,1650,40,"00,02",4,2
455,F,9660,9270,390,"00,04",4,8
456,F,9050,8500,550,"00,06",1,4
457,D,14040,13750,290,"00,02",4,2
458,F,9700,9310,390,"00,04",1,7
459,J,3350,3280,70,"00,02",3,1
460,D,14710,13970,740,"00,05",9,7
461,F,12130,11880,250,"00,02",1,3
462,J,2560,2450,110,"00,04",7,5
463,C,14120,14120,0,"00,00",6,7
464,D,9010,8910,100,"00,01",10,3
465,D,7900,7580,320,"00,04",9,4
466,D,12670,11900,770,"00,06",10,2
467,A,9480,9480,0,"00,00",6,0
468,I,1080,1080,0,"00,00",3,10
469,K,7270,7120,150,"00,02",8,8
470,L,7950,7470,480,"00,06",5,7
471,L,5620,5390,230,"00,04",3,10
472,J,5640,5350,290,"00,05",4,1
473,J,1460,1440,20,"00,01",10,9
474,L,3090,3020,70,"00,02",9,10
475,D,8900,8810,90,"00,01",3,2
476,L,7400,6880,520,"00,07",2,8
477,F,12170,11920,250,"00,02",8,9
478,E,8740,8300,440,"00,05",8,8
479,J,6750,6610,140,"00,02",5,1
480,D,14260,13680,580,"00,04",10,7
481,J,1090,1060,30,"00,03",3,0
482,D,9020,8560,460,"00,05",8,7
483,J,7440,7360,80,"00,01",4,2
484,J,430,420,10,"00,02",10,7
485,D,12980,12840,140,"00,01",7,6
486,D,15600,14970,630,"00,04",4,2
487,F,11900,11660,240,"00,02",2,3
488,F,8630,8450,180,"00,02",6,7
489,L,3450,3410,40,"00,01",3,10
490,D,12090,11600,490,"00,04",4,3
491,L,7540,7460,80,"00,01",2,4
492,L,4450,4270,180,"00,04",4,7
493,F,9370,8990,380,"00,04",3,9
494,F,12000,11260,740,"00,06",1,5
495,F,10410,10200,210,"00,02",7,9
496,F,9150,8600,550,"00,06",2,8
497,J,6250,6060,190,"00,03",4,2
498,J,5780,5540,240,"00,04",7,6
499,F,10860,10420,440,"00,04",4,9
500,D,13590,12630,960,"00,07",10,1
501,E,12260,12130,130,"00,01",7,7
502,F,8250,8160,90,"00,01",4,8
503,J,5760,5700,60,"00,01",7,0
504,D,12520,12260,260,"00,02",8,6
505,D,13020,12490,530,"00,04",6,3
506,J,6120,5690,430,"00,07",4,3
507,I,5440,5440,0,"00,00",3,10
508,D,9050,8860,190,"00,02",8,1
509,F,14610,14310,300,"00,02",2,6
510,L,5630,5510,120,"00,02",6,10
511,D,10540,10320,220,"00,02",10,8
512,L,1950,1850,100,"00,05",4,5
513,D,12400,11900,500,"00,04",8,2
514,E,13140,12480,660,"00,05",9,9
515,I,100,100,0,"00,00",1,9
516,L,5540,5310,230,"00,04",4,9
517,D,10420,10000,420,"00,04",8,7
518,J,2410,2280,130,"00,05",5,1
519,D,13150,12750,400,"00,03",10,8
520,F,13720,13300,420,"00,03",4,7
521,J,2280,2250,30,"00,01",3,1
522,J,1230,1210,20,"00,02",2,0
523,D,15090,14630,460,"00,03",5,2
524,F,15840,14880,960,"00,06",8,10
525,J,2730,2670,60,"00,02",10,4
526,E,11100,10430,670,"00,06",1,1
527,J,3360,3190,170,"00,05",9,0
528,E,10660,10120,540,"00,05",7,7
529,L,1920,1880,40,"00,02",2,4
530,F,9500,9020,480,"00,05",1,4
531,J,5190,5030,160,"00,03",8,6
532,L,2260,2160,100,"00,04",6,9
533,L,1830,1770,60,"00,03",1,7
534,F,7970,7650,320,"00,04",1,7
535,F,10500,10100,400,"00,04",1,2
536,D,15130,14070,1060,"00,07",8,5
537,E,9040,8850,190,"00,02",7,7
538,J,5920,5500,420,"00,07",9,5
539,B,14480,14480,0,"00,00",5,5
540,D,12270,11530,740,"00,06",2,0
541,L,7040,6610,430,"00,06",3,5
542,L,7510,7050,460,"00,06",3,5
543,F,14760,14460,300,"00,02",7,9
544,L,7170,6810,360,"00,05",1,8
545,I,1140,1140,0,"00,00",5,10
546,D,13710,13430,280,"00,02",10,4
547,D,8210,7710,500,"00,06",1,0
548,F,13340,12400,940,"00,07",3,5
549,B,14190,14190,0,"00,00",4,4
550,J,3030,2930,100,"00,03",10,8
551,J,6640,6570,70,"00,01",7,5
552,K,2170,2100,70,"00,03",3,3
553,D,8950,8500,450,"00,05",10,2
554,E,12260,11400,860,"00,07",10,10
555,D,13510,13370,140,"00,01",4,2
556,J,1540,1520,20,"00,01",7,6
557,J,1640,1590,50,"00,03",6,1
558,J,6080,5770,310,"00,05",8,1
559,F,8950,8860,90,"00,01",1,3
560,J,3200,3100,100,"00,03",7,6
561,F,14310,14160,150,"00,01",1,9
562,L,6850,6500,350,"00,05",6,8
563,J,600,590,10,"00,02",2,0
564,F,15300,14990,310,"00,02",4,7
565,F,9250,9150,100,"00,01",7,9
566,F,14530,13650,880,"00,06",4,6
567,E,13160,12500,660,"00,05",2,2
568,J,2150,2040,110,"00,05",6,2
569,D,11170,10610,560,"00,05",3,0
570,F,15150,14080,1070,"00,07",2,4
571,D,9400,9020,380,"00,04",4,3
572,D,15360,14430,930,"00,06",9,5
573,I,7140,7140,0,"00,00",2,6
574,L,7330,6810,520,"00,07",6,9
575,D,8980,8620,360,"00,04",6,3
576,D,15690,14740,950,"00,06",3,0
577,L,7050,6760,290,"00,04",2,4
578,L,5750,5340,410,"00,07",5,8
579,D,10520,10410,110,"00,01",9,4
580,K,4020,3890,130,"00,03",6,6
581,C,11670,11670,0,"00,00",8,10
582,L,6230,5980,250,"00,04",3,5
583,K,6130,5880,250,"00,04",9,9
584,D,9250,8690,560,"00,06",4,3
585,Z,0,0,0,"00,00",0,8
586,K,6540,6140,400,"00,06",2,2
587,F,14030,13600,430,"00,03",5,6
588,L,780,750,30,"00,04",3,4
589,D,8130,7640,490,"00,06",10,7
590,F,12230,11370,860,"00,07",6,10
591,F,8470,8300,170,"00,02",1,3
592,F,9070,8790,280,"00,03",2,8
593,D,8260,8090,170,"00,02",9,3
594,D,15490,14400,1090,"00,07",8,2
595,L,6710,6500,210,"00,03",3,7
596,J,7060,6630,430,"00,06",4,2
597,G,6060,6060,0,"00,00",8,3
598,J,5040,4980,60,"00,01",2,0
599,A,14960,14960,0,"00,00",8,7
600,E,11750,11510,240,"00,02",8,8
601,F,8290,8200,90,"00,01",1,10
602,D,12160,11790,370,"00,03",6,1
603,F,10630,10310,320,"00,03",4,7
604,K,5070,4810,260,"00,05",4,4
605,J,4530,4480,50,"00,01",7,5
606,L,5910,5550,360,"00,06",1,4
607,D,11820,11340,480,"00,04",7,3
608,F,15440,14660,780,"00,05",3,6
609,C,14640,14640,0,"00,00",3,9
610,J,6990,6500,490,"00,07",10,5
611,D,8230,7980,250,"00,03",6,5
612,D,9970,9470,500,"00,05",7,4
613,F,10950,10510,440,"00,04",3,9
614,F,8090,7680,410,"00,05",8,9
615,L,1090,1070,20,"00,02",4,5
616,D,13080,12160,920,"00,07",3,0
617,L,1220,1200,20,"00,02",6,8
618,J,3900,3740,160,"00,04",9,3
619,D,12680,12170,510,"00,04",7,5
620,D,13260,12720,540,"00,04",10,4
621,E,11580,11230,350,"00,03",8,8
622,L,7100,6740,360,"00,05",4,5
623,D,14170,13460,710,"00,05",9,5
624,J,2130,2020,110,"00,05",8,3
625,J,5710,5650,60,"00,01",6,1
626,D,14380,13510,870,"00,06",10,8
627,F,10780,10560,220,"00,02",2,7
628,K,5170,5060,110,"00,02",3,3
629,I,4040,4040,0,"00,00",5,8
630,F,13870,12890,980,"00,07",4,6
631,E,13170,12900,270,"00,02",4,4
632,L,7340,7110,230,"00,03",5,9
633,A,12940,12940,0,"00,00",7,3
634,L,4150,3940,210,"00,05",2,9
635,F,8820,8460,360,"00,04",7,8
636,E,9100,8640,460,"00,05",10,10
637,J,6300,6170,130,"00,02",10,5
638,J,5040,4830,210,"00,04",7,0
639,F,13080,12680,400,"00,03",5,7
640,F,14730,14140,590,"00,04",8,10
641,L,3860,3660,200,"00,05",4,5
642,D,11930,11210,720,"00,06",7,5
643,F,8600,8510,90,"00,01",6,10
644,D,12760,12500,260,"00,02",5,2
645,J,4700,4510,190,"00,04",4,0
646,E,12910,12000,910,"00,07",10,10
647,J,6430,6300,130,"00,02",10,1
648,K,7200,7050,150,"00,02",4,4
649,D,12020,11770,250,"00,02",5,4
650,J,7270,6760,510,"00,07",9,8
651,L,1290,1270,20,"00,02",5,7
652,D,14530,14090,440,"00,03",3,0
653,J,7550,7470,80,"00,01",2,0
654,L,6910,6700,210,"00,03",1,10
655,D,15290,14830,460,"00,03",6,0
656,E,13170,12640,530,"00,04",5,5
657,F,9750,9650,100,"00,01",1,7
658,L,5180,4810,370,"00,07",2,4
659,F,11350,10890,460,"00,04",2,9
660,J,7680,7140,540,"00,07",7,2
661,F,9100,9000,100,"00,01",1,9
662,J,2530,2420,110,"00,04",9,1
663,D,13860,13300,560,"00,04",10,2
664,L,7390,6940,450,"00,06",1,8
665,F,11510,11270,240,"00,02",4,7
666,E,11570,11100,470,"00,04",4,4
667,L,4750,4600,150,"00,03",3,10
668,J,1870,1810,60,"00,03",3,0
669,J,4280,4230,50,"00,01",9,6
670,J,7310,6940,370,"00,05",10,9
671,F,8830,8740,90,"00,01",4,7
672,L,3230,3100,130,"00,04",5,10
673,D,11450,10990,460,"00,04",10,8
674,L,4640,4450,190,"00,04",3,4
675,D,15150,14690,460,"00,03",4,3
676,F,10040,9330,710,"00,07",3,10
677,F,9980,9680,300,"00,03",3,8
678,J,7760,7370,390,"00,05",9,5
679,G,5130,5130,0,"00,00",3,0
680,F,9630,8950,680,"00,07",1,7
681,D,8090,7920,170,"00,02",5,4
682,L,4380,4240,140,"00,03",1,7
683,D,11890,11530,360,"00,03",5,1
684,L,3470,3360,110,"00,03",1,4
685,K,3190,3120,70,"00,02",9,9
686,J,7810,7410,400,"00,05",7,5
687,K,7170,7090,80,"00,01",9,9
688,L,5740,5560,180,"00,03",2,5
689,I,2180,2180,0,"00,00",1,7
690,L,3270,3130,140,"00,04",8,9
691,C,14900,14900,0,"00,00",3,9
692,L,6200,6010,190,"00,03",5,6
693,D,11130,11010,120,"00,01",4,3
694,K,4370,4190,180,"00,04",5,5
695,I,1020,1020,0,"00,00",5,10
696,J,6300,6110,190,"00,03",8,5
697,I,5250,5250,0,"00,00",1,8
698,F,10230,9610,620,"00,06",1,8
699,I,200,200,0,"00,00",2,4
700,L,5530,5300,230,"00,04",4,7
701,G,3050,3050,0,"00,00",7,5
702,E,10410,10090,320,"00,03",7,7
703,G,3040,3040,0,"00,00",8,6
704,L,680,660,20,"00,03",3,9
705,J,3510,3470,40,"00,01",3,1
706,K,580,570,10,"00,02",2,2
707,F,12830,12700,130,"00,01",5,10
708,F,8970,8870,100,"00,01",5,8
709,L,390,380,10,"00,03",2,10
710,F,12300,11430,870,"00,07",5,7
711,D,11600,11250,350,"00,03",5,2
712,E,15470,14380,1090,"00,07",7,7
713,E,12680,12550,130,"00,01",8,8
714,F,10640,10210,430,"00,04",9,10
715,J,4890,4740,150,"00,03",6,5
716,D,9450,8970,480,"00,05",9,6
717,J,6330,6070,260,"00,04",5,2
718,J,7810,7410,400,"00,05",10,2
719,G,3690,3690,0,"00,00",10,6
720,F,10630,9880,750,"00,07",1,4
721,L,1880,1860,20,"00,01",5,9
722,E,10600,9960,640,"00,06",5,5
723,F,10190,10080,110,"00,01",1,4
724,E,13460,13190,270,"00,02",2,2
725,L,3750,3670,80,"00,02",7,10
726,J,1980,1880,100,"00,05",10,3
727,D,9770,9670,100,"00,01",10,2
728,D,14220,13500,720,"00,05",10,5
729,J,3350,3210,140,"00,04",3,1
730,J,6380,6060,320,"00,05",8,0
731,H,6710,6710,0,"00,00",1,1
732,D,9450,9070,380,"00,04",4,3
733,D,10240,10130,110,"00,01",5,2
734,D,8460,8030,430,"00,05",10,4
735,A,10230,10230,0,"00,00",9,3
736,D,13040,12510,530,"00,04",10,7
737,F,11260,11030,230,"00,02",7,9
738,K,4250,4120,130,"00,03",9,9
739,Z,0,0,0,"00,00",0,2
740,D,15920,14800,1120,"00,07",8,4
741,L,4500,4400,100,"00,02",8,9
742,D,8080,7750,330,"00,04",2,0
743,I,3170,3170,0,"00,00",2,3
744,L,5100,4990,110,"00,02",1,3
745,J,1920,1820,100,"00,05",5,2
746,D,14860,13960,900,"00,06",10,0
747,L,5500,5220,280,"00,05",3,4
748,D,15100,14190,910,"00,06",5,4
749,J,440,430,10,"00,02",2,0
750,L,3500,3390,110,"00,03",2,5
751,F,10580,10470,110,"00,01",5,7
752,L,7140,6710,430,"00,06",3,9
753,D,9590,9010,580,"00,06",10,2
754,F,13910,12930,980,"00,07",2,7
755,G,4810,4810,0,"00,00",4,2
756,E,12820,12300,520,"00,04",9,9
757,C,13780,13780,0,"00,00",3,4
758,B,8690,8690,0,"00,00",3,3
759,I,1870,1870,0,"00,00",2,7
760,L,2840,2720,120,"00,04",6,7
761,J,4710,4610,100,"00,02",9,2
762,K,6840,6490,350,"00,05",10,10
763,J,4440,4390,50,"00,01",10,5
764,L,6410,5960,450,"00,07",5,9
765,G,2360,2360,0,"00,00",6,0
766,F,9160,8880,280,"00,03",2,9
767,D,15020,14860,160,"00,01",8,2
768,J,1530,1510,20,"00,01",7,6
769,F,10830,10720,110,"00,01",3,4
770,D,13150,13010,140,"00,01",9,8
771,D,8910,8550,360,"00,04",10,5
772,F,12130,11280,850,"00,07",3,9
773,I,7410,7410,0,"00,00",3,9
774,J,4470,4290,180,"00,04",4,2
775,D,10410,9880,530,"00,05",10,4
776,J,2060,1950,110,"00,05",3,0
777,J,6600,6530,70,"00,01",10,4
778,L,1500,1480,20,"00,01",3,5
779,D,11140,11020,120,"00,01",10,8
780,L,5880,5700,180,"00,03",3,8
781,D,15100,14640,460,"00,03",5,2
782,J,2210,2140,70,"00,03",9,3
783,F,15370,14750,620,"00,04",1,8
784,L,4100,3930,170,"00,04",4,7
785,L,5870,5750,120,"00,02",4,8
786,J,430,420,10,"00,02",4,3
787,J,4570,4380,190,"00,04",8,5
788,J,7070,6710,360,"00,05",5,3
789,G,6390,6390,0,"00,00",10,0
790,J,2690,2660,30,"00,01",6,0
791,I,4650,4650,0,"00,00",4,7
792,D,9480,9100,380,"00,04",3,1
793,L,780,770,10,"00,01",1,6
794,F,12400,11530,870,"00,07",1,4
795,E,9830,9430,400,"00,04",5,5
796,L,6130,5760,370,"00,06",4,5
797,D,9610,9410,200,"00,02",8,6
798,K,5230,5020,210,"00,04",9,9
799,D,9330,9230,100,"00,01",10,6
800,F,8480,7880,600,"00,07",6,8
801,J,7130,6770,360,"00,05",6,1
802,J,6360,5910,450,"00,07",8,0
803,C,12490,12490,0,"00,00",5,8
804,J,1150,1120,30,"00,03",9,5
805,I,3140,3140,0,"00,00",1,2
806,D,12480,11850,630,"00,05",7,4
807,K,2270,2220,50,"00,02",1,1
808,L,310,300,10,"00,03",1,5
809,J,3980,3930,50,"00,01",7,1
810,L,5270,5160,110,"00,02",3,7
811,A,13150,13150,0,"00,00",10,4
812,F,11140,10580,560,"00,05",5,6
813,J,2770,2740,30,"00,01",10,6
814,L,510,490,20,"00,04",3,7
815,J,1610,1590,20,"00,01",7,5
816,D,9520,9230,290,"00,03",10,3
817,F,8260,8010,250,"00,03",7,8
818,F,14060,13630,430,"00,03",9,10
819,A,10180,10180,0,"00,00",5,1
820,J,650,630,20,"00,03",9,1
821,C,9310,9310,0,"00,00",8,9
822,L,4940,4890,50,"00,01",4,7
823,D,8690,8340,350,"00,04",8,5
824,J,1650,1580,70,"00,04",2,1
825,F,7980,7500,480,"00,06",3,5
826,J,6630,6230,400,"00,06",6,4
827,F,13470,13330,140,"00,01",5,8
828,F,11700,11110,590,"00,05",2,7
829,D,8090,7760,330,"00,04",7,3
830,L,5700,5350,350,"00,06",2,8
831,C,10030,10030,0,"00,00",2,3
832,F,12760,12120,640,"00,05",1,7
833,D,7900,7580,320,"00,04",10,8
834,F,11010,10450,560,"00,05",2,8
835,D,11850,11610,240,"00,02",5,2
836,D,12910,12000,910,"00,07",8,5
837,L,2700,2610,90,"00,03",3,4
838,E,10930,10380,550,"00,05",3,3
839,E,15780,14670,1110,"00,07",6,6
840,D,15750,14640,1110,"00,07",3,1
841,K,4850,4800,50,"00,01",1,1
842,F,11620,11380,240,"00,02",1,8
843,L,7410,7330,80,"00,01",1,9
844,L,5930,5510,420,"00,07",8,9
845,I,100,100,0,"00,00",1,3
846,J,4390,4300,90,"00,02",7,0
847,G,6280,6280,0,"00,00",1,0
848,F,13490,13210,280,"00,02",7,9
849,I,3760,3760,0,"00,00",2,4
850,F,10340,10130,210,"00,02",3,9
851,D,13510,13230,280,"00,02",9,5
852,J,5510,5390,120,"00,02",3,0
853,L,7550,7240,310,"00,04",2,4
854,D,14800,13910,890,"00,06",4,0
855,L,860,830,30,"00,03",2,4
856,L,7360,6990,370,"00,05",6,7
857,D,11430,11310,120,"00,01",9,0
858,J,2670,2640,30,"00,01",8,1
859,J,2480,2450,30,"00,01",6,1
860,J,1090,1050,40,"00,04",3,0
861,D,13400,12880,520,"00,04",10,0
862,L,360,340,20,"00,06",1,2
863,L,5070,4910,160,"00,03",3,10
864,D,9810,9410,400,"00,04",7,6
865,D,12450,12320,130,"00,01",9,1
866,D,11530,10830,700,"00,06",10,9
867,D,7660,7500,160,"00,02",8,7
868,F,9170,8610,560,"00,06",2,9
869,J,5410,5350,60,"00,01",10,6
870,L,3650,3540,110,"00,03",6,8
871,D,12550,11700,850,"00,07",5,3
872,F,12800,11840,960,"00,08",3,6
873,L,420,410,10,"00,02",3,4
874,J,3810,3650,160,"00,04",7,2
875,G,1280,1280,0,"00,00",8,0
876,K,1300,1250,50,"00,04",3,3
877,F,9800,9210,590,"00,06",5,9
878,F,13700,12740,960,"00,07",1,3
879,J,4160,4030,130,"00,03",5,2
880,F,11280,10820,460,"00,04",2,9
881,D,10050,9640,410,"00,04",8,1
882,L,6180,5800,380,"00,06",5,8
883,A,12780,12780,0,"00,00",8,1
884,F,10380,10270,110,"00,01",9,10
885,J,2110,2060,50,"00,02",8,2
886,K,1890,1810,80,"00,04",10,10
887,F,11830,11710,120,"00,01",1,7
888,E,12290,11670,620,"00,05",9,9
889,E,13590,13040,550,"00,04",2,2
890,E,11800,11090,710,"00,06",9,9
891,F,13930,13510,420,"00,03",6,7
892,J,4920,4770,150,"00,03",4,1
893,I,4020,4020,0,"00,00",2,5
894,D,14560,14120,440,"00,03",5,1
895,J,2880,2820,60,"00,02",8,6
896,L,4370,4150,220,"00,05",8,9
897,F,14700,14550,150,"00,01",3,4
898,F,12650,11760,890,"00,07",2,9
899,K,670,660,10,"00,01",1,1
900,D,15210,14600,610,"00,04",9,1
901,F,9570,9280,290,"00,03",2,6
902,L,2260,2190,70,"00,03",8,9
903,A,8590,8590,0,"00,00",7,3
904,D,9480,9100,380,"00,04",8,6
905,I,1050,1050,0,"00,00",8,9
906,F,13180,12780,400,"00,03",4,6
907,J,4550,4500,50,"00,01",7,2
908,L,6310,6240,70,"00,01",8,10
909,D,9620,9420,200,"00,02",5,4
910,J,6310,5990,320,"00,05",5,0
911,G,3550,3550,0,"00,00",9,2
912,D,14020,13310,710,"00,05",6,1
913,A,9040,9040,0,"00,00",9,8
914,D,10320,9700,620,"00,06",8,3
915,K,4660,4420,240,"00,05",5,5
916,E,14610,13580,1030,"00,07",2,2
917,J,5760,5580,180,"00,03",1,0
918,L,7380,7010,370,"00,05",1,6
919,L,970,960,10,"00,01",2,4
920,D,12330,11950,380,"00,03",1,0
921,F,8870,8510,360,"00,04",3,6
922,D,12390,11640,750,"00,06",2,1
923,L,2200,2130,70,"00,03",6,10
924,F,12490,11740,750,"00,06",2,10
925,J,3040,2940,100,"00,03",4,3
926,D,8250,7670,580,"00,07",6,0
927,G,7080,7080,0,"00,00",6,3
928,L,7610,7450,160,"00,02",6,7
929,F,15190,14880,310,"00,02",8,10
930,F,13040,12120,920,"00,07",4,9
931,J,1800,1780,20,"00,01",8,0
932,F,14240,13520,720,"00,05",2,7
933,J,2400,2350,50,"00,02",1,0
934,D,10560,10030,530,"00,05",6,1
935,H,1380,1380,0,"00,00",2,2
936,F,13410,12600,810,"00,06",2,7
937,D,12200,12070,130,"00,01",4,2
938,L,3220,3150,70,"00,02",1,6
939,F,10530,10310,220,"00,02",2,5
940,L,2930,2780,150,"00,05",4,7
941,D,11860,11500,360,"00,03",10,5
942,L,7370,6920,450,"00,06",2,8
943,C,12290,12290,0,"00,00",1,5
944,L,3410,3340,70,"00,02",1,8
945,K,580,560,20,"00,03",1,1
946,L,4960,4710,250,"00,05",4,9
947,F,10510,10080,430,"00,04",3,6
948,J,6220,5900,320,"00,05",10,5
949,K,680,670,10,"00,01",4,4
950,L,3670,3550,120,"00,03",3,10
951,L,6270,6140,130,"00,02",1,3
952,D,7820,7580,240,"00,03",6,2
953,D,13380,13110,270,"00,02",10,0
954,K,2990,2920,70,"00,02",4,4
955,J,6440,6240,200,"00,03",9,8
956,D,8650,8040,610,"00,07",8,1
957,A,13270,13270,0,"00,00",4,2
958,J,3220,3050,170,"00,05",7,4
959,F,12170,12040,130,"00,01",2,9
960,E,8510,8080,430,"00,05",7,7
961,D,8000,7910,90,"00,01",8,3
962,E,8630,8110,520,"00,06",10,10
963,D,11910,11670,240,"00,02",7,0
964,F,10390,9660,730,"00,07",2,5
965,J,6430,6300,130,"00,02",5,4
966,D,10060,9550,510,"00,05",7,0
967,J,3200,3100,100,"00,03",3,0
968,F,11170,10610,560,"00,05",5,8
969,J,510,490,20,"00,04",2,0
970,F,11310,10740,570,"00,05",4,10
971,I,1180,1180,0,"00,00",8,9
972,E,14980,14530,450,"00,03",9,9
973,F,8870,8510,360,"00,04",6,7
974,D,11890,11170,720,"00,06",6,4
975,F,10440,10020,420,"00,04",7,10
976,J,4670,4480,190,"00,04",7,1
977,D,11400,10940,460,"00,04",8,3
978,K,1610,1540,70,"00,04",7,7
979,A,14630,14630,0,"00,00",6,0
980,F,15010,14550,460,"00,03",3,6
981,D,9600,9310,290,"00,03",8,5
982,F,10050,9340,710,"00,07",3,10
983,F,9650,9070,580,"00,06",5,8
984,D,10690,10040,650,"00,06",9,2
985,D,11610,11370,240,"00,02",2,1
986,F,8450,7940,510,"00,06",1,8
987,F,8660,8570,90,"00,01",2,5
988,D,11290,11060,230,"00,02",8,5
989,J,4980,4780,200,"00,04",7,6
990,D,13680,12720,960,"00,07",8,4
991,G,3100,3100,0,"00,00",6,5
992,L,5460,5070,390,"00,07",5,8
993,D,9350,8970,380,"00,04",9,5
994,D,10130,9620,510,"00,05",8,5
995,J,2190,2160,30,"00,01",9,6
996,J,2910,2790,120,"00,04",7,0
997,G,2760,2760,0,"00,00",4,1
998,K,1430,1400,30,"00,02",4,4
999,C,14280,14280,0,"00,00",7,9
1000,D,11510,11040,470,"00,04",9,8
1001,G,3500,3500,0,"00,00",7,0
1002,L,3220,3050,170,"00,05",4,7
1003,D,10750,10530,220,"00,02",8,3
1004,D,11360,10670,690,"00,06",6,3
1005,G,3890,3890,0,"00,00",6,4
1006,F,11740,11150,590,"00,05",2,5
1007,D,9140,8860,280,"00,03",10,9
1008,F,13930,12950,980,"00,07",4,7
1009,C,7750,7750,0,"00,00",6,8
1010,L,290,280,10,"00,03",2,8
1011,J,4690,4640,50,"00,01",8,5
1012,L,4980,4780,200,"00,04",2,10
1013,J,3460,3350,110,"00,03",9,5
1014,D,8960,8420,540,"00,06",10,6
1015,F,11670,11310,360,"00,03",1,3
1016,D,9380,9000,380,"00,04",7,6
1017,F,13110,12970,140,"00,01",5,6
1018,F,11090,10640,450,"00,04",6,8
1019,L,6630,6360,270,"00,04",4,7
1020,J,4570,4340,230,"00,05",9,7
1021,I,3580,3580,0,"00,00",6,9
1022,D,11850,11020,830,"00,07",9,4
1023,L,3910,3870,40,"00,01",2,8
1024,J,600,590,10,"00,02",3,0
1025,Z,0,0,0,"00,00",0,7
1026,E,13540,13260,280,"00,02",1,1
1027,L,3810,3770,40,"00,01",3,9
1028,J,4810,4560,250,"00,05",3,1
1029,J,7090,6730,360,"00,05",8,0
1030,F,8150,7660,490,"00,06",1,6
1031,G,5310,5310,0,"00,00",1,0
1032,F,10100,9690,410,"00,04",6,9
1033,D,12210,12080,130,"00,01",10,2
1034,K,3820,3660,160,"00,04",6,6
1035,A,8200,8200,0,"00,00",7,3
1036,J,310,300,10,"00,03",4,2
1037,K,5770,5530,240,"00,04",7,7
1038,D,15440,14350,1090,"00,07",8,1
1039,J,7220,6930,290,"00,04",2,1
1040,F,8170,7840,330,"00,04",1,3
1041,F,13090,12560,530,"00,04",5,6
1042,D,11790,11200,590,"00,05",1,0
1043,C,12790,12790,0,"00,00",4,8
1044,F,9590,9200,390,"00,04",6,9
1045,J,2830,2740,90,"00,03",7,6
1046,L,7650,7340,310,"00,04",1,10
1047,D,9160,8880,280,"00,03",5,4
1048,F,13210,12280,930,"00,07",1,2
1049,B,11220,11220,0,"00,00",9,9
1050,Z,0,0,0,"00,00",0,3
1051,A,10590,10590,0,"00,00",4,2
1052,F,11020,10900,120,"00,01",9,10
1053,B,14320,14320,0,"00,00",7,7
1054,F,12500,11990,510,"00,04",1,5
1055,J,7720,7410,310,"00,04",8,7
1056,J,5520,5240,280,"00,05",9,2
1057,J,430,420,10,"00,02",5,0
1058,D,10110,9800,310,"00,03",6,4
1059,E,14270,14120,150,"00,01",9,9
1060,L,710,680,30,"00,04",1,4
1061,G,2130,2130,0,"00,00",10,3
1062,E,15090,14180,910,"00,06",1,1
1063,L,500,480,20,"00,04",1,3
1064,J,7300,7000,300,"00,04",6,1
1065,E,13760,13480,280,"00,02",7,7
1066,F,13460,12780,680,"00,05",1,3
1067,J,1320,1300,20,"00,02",3,1
1068,J,1830,1770,60,"00,03",9,1
1069,D,14030,13460,570,"00,04",3,0
1070,J,5020,4810,210,"00,04",10,7
1071,C,8830,8830,0,"00,00",8,10
1072,D,14320,14170,150,"00,01",5,2
1073,F,9190,8910,280,"00,03",5,9
1074,F,12200,11710,490,"00,04",3,8
1075,F,9160,9060,100,"00,01",4,8
1076,L,7680,7370,310,"00,04",7,10
1077,I,4740,4740,0,"00,00",7,9
1078,L,1800,1720,80,"00,04",1,4
1079,D,13690,13140,550,"00,04",2,1
1080,F,11730,10900,830,"00,07",2,9
1081,J,4970,4910,60,"00,01",10,2
1082,F,9420,8760,660,"00,07",2,4
1083,D,9500,9400,100,"00,01",6,3
1084,E,9720,9420,300,"00,03",1,1
1085,J,1400,1380,20,"00,01",9,2
1086,L,6100,5730,370,"00,06",1,6
1087,F,10760,10540,220,"00,02",7,10
1088,D,13320,12780,540,"00,04",4,1
1089,F,12450,11820,630,"00,05",1,4
1090,L,2640,2500,140,"00,05",1,9
1091,C,14580,14580,0,"00,00",3,7
1092,D,8870,8600,270,"00,03",7,6
1093,L,4550,4500,50,"00,01",3,9
1094,J,4640,4450,190,"00,04",6,2
1095,J,1810,1730,80,"00,04",9,4
1096,F,11510,10810,700,"00,06",4,5
1097,G,6670,6670,0,"00,00",7,6
1098,J,7710,7400,310,"00,04",8,7
1099,B,10360,10360,0,"00,00",7,7
1100,G,6470,6470,0,"00,00",10,2
1101,F,12720,11950,770,"00,06",4,10
1102,D,9680,9000,680,"00,07",2,0
1103,I,3420,3420,0,"00,00",1,7
1104,D,8300,8050,250,"00,03",7,3
1105,C,7560,7560,0,"00,00",5,8
1106,J,6430,6040,390,"00,06",4,0
1107,J,7760,7370,390,"00,05",7,4
1108,L,6270,5890,380,"00,06",2,3
1109,I,100,100,0,"00,00",1,2
1110,J,6410,6210,200,"00,03",7,1
1111,L,260,250,10,"00,04",1,9
1112,D,11200,10410,790,"00,07",9,1
1113,J,5470,5250,220,"00,04",2,1
1114,J,7720,7170,550,"00,07",6,1
1115,C,14640,14640,0,"00,00",2,6
1116,D,9330,8670,660,"00,07",7,3
1117,F,14530,14230,300,"00,02",6,8
1118,L,7360,7130,230,"00,03",4,7
1119,F,8170,8000,170,"00,02",1,9
1120,D,8890,8350,540,"00,06",7,3
1121,D,9610,9410,200,"00,02",10,3
1122,D,13350,12540,810,"00,06",7,1
1123,D,11170,10720,450,"00,04",4,2
1124,F,14590,13560,1030,"00,07",5,6
1125,G,1640,1640,0,"00,00",7,1
1126,D,8160,8070,90,"00,01",10,5
1127,L,7170,6880,290,"00,04",3,10
1128,J,6780,6440,340,"00,05",8,0
1129,L,3450,3310,140,"00,04",1,9
1130,J,3500,3320,180,"00,05",6,0
1131,J,5980,5680,300,"00,05",5,2
1132,D,11460,10880,580,"00,05",4,3
1133,D,9940,9640,300,"00,03",9,1
1134,D,9720,9230,490,"00,05",5,1
1135,I,2050,2050,0,"00,00",2,7
1136,D,10030,9920,110,"00,01",10,2
1137,D,8460,8200,260,"00,03",10,7
1138,F,14890,13990,900,"00,06",6,9
1139,I,100,100,0,"00,00",1,2
1140,L,5680,5560,120,"00,02",1,2
1141,L,3610,3530,80,"00,02",3,6
1142,J,1350,1300,50,"00,04",2,0
1143,J,4930,4630,300,"00,06",10,1
1144,F,11020,10240,780,"00,07",1,4
1145,K,1510,1490,20,"00,01",8,8
1146,F,10550,10230,320,"00,03",1,5
1147,G,5730,5730,0,"00,00",10,4
1148,F,10070,9560,510,"00,05",3,4
1149,L,6740,6600,140,"00,02",5,8
1150,L,5110,5000,110,"00,02",5,8
1151,L,1330,1310,20,"00,02",6,10
1152,J,4900,4700,200,"00,04",10,7
1153,L,7270,7190,80,"00,01",6,10
1154,F,13780,13500,280,"00,02",5,8
1155,F,9080,8890,190,"00,02",1,2
1156,F,12400,12020,380,"00,03",2,4
1157,J,7470,7320,150,"00,02",5,0
1158,L,400,390,10,"00,03",2,8
1159,L,3720,3640,80,"00,02",6,10
1160,D,13190,12790,400,"00,03",10,0
1161,L,5240,5130,110,"00,02",4,10
1162,F,12160,11670,490,"00,04",1,8
1163,F,9950,9350,600,"00,06",4,5
1164,F,12520,11760,760,"00,06",1,10
1165,F,9670,9370,300,"00,03",4,5
1166,D,12300,11800,500,"00,04",9,0
1167,G,5730,5730,0,"00,00",10,8
1168,D,13470,12790,680,"00,05",9,0
1169,K,6860,6720,140,"00,02",10,10
1170,F,12470,11590,880,"00,07",4,9
1171,D,11710,11000,710,"00,06",9,8
1172,F,14250,13250,1000,"00,07",6,9
1173,J,2750,2610,140,"00,05",8,5
1174,J,4940,4590,350,"00,07",3,2
1175,F,12530,12400,130,"00,01",1,3
1176,L,3450,3340,110,"00,03",4,9
1177,C,12000,12000,0,"00,00",6,9
1178,F,9680,9090,590,"00,06",1,9
1179,J,1270,1250,20,"00,02",3,1
1180,D,15270,14810,460,"00,03",5,4
1181,L,2030,2000,30,"00,01",7,9
1182,D,13150,12490,660,"00,05",10,3
1183,F,12110,11740,370,"00,03",1,10
1184,D,12320,11580,740,"00,06",10,3
1185,K,2250,2180,70,"00,03",6,6
1186,D,14860,14260,600,"00,04",8,6
1187,A,8230,8230,0,"00,00",10,0
1188,E,14010,13160,850,"00,06",10,10
1189,F,8570,8480,90,"00,01",3,5
1190,J,4270,4090,180,"00,04",10,3
1191,D,8560,8470,90,"00,01",5,0
1192,D,15110,14050,1060,"00,07",3,2
1193,D,9100,8820,280,"00,03",7,0
1194,D,13130,12210,920,"00,07",10,0
1195,F,11110,10880,230,"00,02",3,4
1196,L,5680,5560,120,"00,02",1,4
1197,F,11610,11370,240,"00,02",1,6
1198,L,3180,3080,100,"00,03",1,10
1199,K,4140,4010,130,"00,03",8,8
1200,L,5560,5220,340,"00,06",4,10
1201,F,9890,9590,300,"00,03",4,10
1202,D,13420,12740,680,"00,05",9,0
1203,I,200,200,0,"00,00",1,9
1204,J,4390,4250,140,"00,03",4,1
1205,D,14970,14220,750,"00,05",10,2
1206,J,1640,1550,90,"00,05",9,6
1207,F,9050,8590,460,"00,05",3,9
1208,E,13700,12740,960,"00,07",6,6
1209,J,6950,6600,350,"00,05",10,1
1210,D,14610,13870,740,"00,05",5,3
1211,D,13240,13100,140,"00,01",10,0
1212,F,10230,9510,720,"00,07",3,9
1213,J,1350,1330,20,"00,01",6,2
1214,D,15380,14760,620,"00,04",8,2
1215,E,10920,10700,220,"00,02",4,4
1216,F,12590,11700,890,"00,07",6,10
1217,J,1450,1430,20,"00,01",6,3
1218,L,7590,7430,160,"00,02",3,5
1219,I,100,100,0,"00,00",1,2
1220,L,4820,4530,290,"00,06",7,10
1221,H,3320,3320,0,"00,00",3,3
1222,J,2550,2490,60,"00,02",7,3
1223,F,13610,13470,140,"00,01",3,7
1224,F,10870,10430,440,"00,04",2,9
1225,C,12370,12370,0,"00,00",3,4
1226,L,1410,1380,30,"00,02",3,4
1227,J,6320,6190,130,"00,02",10,3
1228,D,13370,12960,410,"00,03",4,2
1229,L,3550,3400,150,"00,04",3,10
1230,D,10700,10160,540,"00,05",10,8
1231,F,8240,7820,420,"00,05",2,10
1232,L,5050,4690,360,"00,07",2,6
1233,D,11500,11380,120,"00,01",9,3
1234,L,5200,4990,210,"00,04",5,9
1235,J,7310,7230,80,"00,01",7,5
1236,D,12270,11410,860,"00,07",3,2
1237,I,1880,1880,0,"00,00",5,8
1238,D,11500,11380,120,"00,01",4,1
1239,L,510,500,10,"00,02",2,10
1240,D,13410,12600,810,"00,06",6,1
1241,L,6480,6410,70,"00,01",4,7
1242,D,9190,8540,650,"00,07",9,2
1243,F,10350,10240,110,"00,01",6,7
1244,L,6230,6100,130,"00,02",4,8
1245,J,6950,6810,140,"00,02",6,1
1246,L,4010,3880,130,"00,03",7,9
1247,L,1980,1950,30,"00,02",2,4
1248,J,5390,5060,330,"00,06",9,1
1249,F,12420,12170,250,"00,02",5,6
1250,D,12620,12110,510,"00,04",2,1
1251,F,14980,14230,750,"00,05",2,10
1252,J,7490,6960,530,"00,07",6,3
1253,J,7380,7010,370,"00,05",10,4
1254,J,7140,6780,360,"00,05",5,1
1255,B,13310,13310,0,"00,00",4,4
1256,L,4400,4220,180,"00,04",2,4
1257,L,980,970,10,"00,01",1,3
1258,E,14910,14160,750,"00,05",4,4
1259,D,10280,10070,210,"00,02",4,2
1260,F,8480,7970,510,"00,06",1,9
1261,D,8840,8220,620,"00,07",10,2
1262,L,3000,2930,70,"00,02",4,7
1263,D,8110,7860,250,"00,03",3,2
1264,L,240,230,10,"00,04",1,2
1265,J,3630,3440,190,"00,05",9,7
1266,J,1050,1020,30,"00,03",9,3
1267,D,9750,9650,100,"00,01",10,7
1268,J,500,490,10,"00,02",3,0
1269,D,10930,10820,110,"00,01",6,0
1270,E,13230,12830,400,"00,03",9,9
1271,F,10630,9990,640,"00,06",3,7
1272,D,13350,12810,540,"00,04",5,2
1273,L,6420,6290,130,"00,02",8,9
1274,D,9850,9160,690,"00,07",9,8
1275,J,5100,4940,160,"00,03",4,0
1276,L,5480,5150,330,"00,06",2,5
1277,J,5750,5460,290,"00,05",8,0
1278,L,3410,3270,140,"00,04",7,10
1279,I,4770,4770,0,"00,00",5,7
1280,L,6100,5670,430,"00,07",6,8
1281,L,3180,3020,160,"00,05",1,6
1282,L,3800,3720,80,"00,02",6,8
1283,D,8750,8310,440,"00,05",10,2
1284,D,14590,14150,440,"00,03",4,3
1285,D,12350,11850,500,"00,04",10,0
1286,A,12510,12510,0,"00,00",10,5
1287,J,5270,5210,60,"00,01",10,1
1288,A,8350,8350,0,"00,00",10,6
1289,L,2520,2390,130,"00,05",6,7
1290,A,10520,10520,0,"00,00",5,1
1291,D,9370,8990,380,"00,04",8,7
1292,E,11420,10620,800,"00,07",7,7
1293,G,2630,2630,0,"00,00",10,0
1294,L,2560,2500,60,"00,02",3,9
1295,J,1360,1310,50,"00,04",1,0
1296,L,4280,4150,130,"00,03",2,10
1297,D,14200,13910,290,"00,02",3,0
1298,J,6410,6150,260,"00,04",5,4
1299,L,5300,5080,220,"00,04",4,6
1300,J,1960,1880,80,"00,04",10,7
1301,L,5760,5640,120,"00,02",2,6
1302,A,7870,7870,0,"00,00",9,5
1303,G,2510,2510,0,"00,00",6,3
1304,F,10120,9410,710,"00,07",7,10
1305,D,8300,7960,340,"00,04",7,2
1306,L,5620,5220,400,"00,07",5,7
1307,L,4950,4750,200,"00,04",4,5
1308,J,5880,5460,420,"00,07",5,4
1309,J,4550,4320,230,"00,05",9,6
1310,E,8220,8050,170,"00,02",7,7
1311,H,2100,2100,0,"00,00",1,1
1312,L,570,550,20,"00,04",1,4
1313,D,11110,10330,780,"00,07",7,2
1314,L,3590,3550,40,"00,01",2,7
1315,F,12070,11220,850,"00,07",1,3
1316,J,1510,1490,20,"00,01",4,0
1317,L,7340,6820,520,"00,07",4,7
1318,D,9600,9020,580,"00,06",6,2
1319,J,3390,3250,140,"00,04",10,6
1320,L,6770,6290,480,"00,07",1,6
1321,L,6210,6080,130,"00,02",3,9
1322,D,14860,14710,150,"00,01",5,1
1323,D,9210,8560,650,"00,07",9,6
1324,F,15100,14640,460,"00,03",4,10
1325,L,3690,3610,80,"00,02",1,4
1326,J,2670,2640,30,"00,01",6,3
1327,F,14150,14000,150,"00,01",1,9
1328,G,4390,4390,0,"00,00",10,4
1329,L,3780,3590,190,"00,05",1,8
1330,A,13230,13230,0,"00,00",4,3
1331,L,3430,3390,40,"00,01",2,6
1332,F,10620,10300,320,"00,03",2,5
1333,K,5610,5440,170,"00,03",4,4
1334,G,7360,7360,0,"00,00",7,3
1335,F,11880,11760,120,"00,01",5,7
1336,G,7400,7400,0,"00,00",7,4
1337,F,14800,14500,300,"00,02",1,9
1338,D,14050,13900,150,"00,01",3,2
1339,Z,0,0,0,"00,00",0,5
1340,E,10660,10440,220,"00,02",1,1
1341,D,9350,8690,660,"00,07",6,1
1342,D,13990,13700,290,"00,02",3,2
1343,J,5380,5000,380,"00,07",10,0
1344,D,10390,9660,730,"00,07",8,7
1345,J,3410,3370,40,"00,01",7,4
1346,D,10120,9810,310,"00,03",8,2
1347,D,14150,14000,150,"00,01",4,3
1348,Z,0,0,0,"00,00",0,4
1349,J,1660,1620,40,"00,02",9,4
1350,F,13360,12820,540,"00,04",3,9
1351,F,10280,9660,620,"00,06",7,8
1352,E,14000,13430,570,"00,04",1,1
1353,G,1600,1600,0,"00,00",7,3
1354,J,5240,4920,320,"00,06",10,2
1355,L,4550,4360,190,"00,04",2,8
1356,I,7370,7370,0,"00,00",7,9
1357,J,6940,6730,210,"00,03",7,6
1358,A,11360,11360,0,"00,00",6,1
1359,D,13620,13070,550,"00,04",9,3
1360,J,530,520,10,"00,02",1,0
1361,L,2520,2490,30,"00,01",3,9
1362,J,300,290,10,"00,03",1,0
1363,K,3760,3720,40,"00,01",1,1
1364,L,4010,3880,130,"00,03",1,5
1365,E,14490,13470,1020,"00,07",2,2
1366,J,5300,5030,270,"00,05",6,5
1367,C,11530,11530,0,"00,00",6,9
1368,G,1630,1630,0,"00,00",9,5
1369,J,4510,4320,190,"00,04",5,1
1370,J,4560,4370,190,"00,04",10,8
1371,A,12810,12810,0,"00,00",9,6
1372,J,5940,5820,120,"00,02",9,0
1373,F,8910,8370,540,"00,06",3,6
1374,J,830,810,20,"00,02",2,1
1375,L,7610,7150,460,"00,06",1,7
1376,F,14220,14070,150,"00,01",2,7
1377,J,5910,5550,360,"00,06",6,2
1378,F,14720,14570,150,"00,01",4,8
1379,D,7820,7500,320,"00,04",9,1
1380,D,14730,14430,300,"00,02",10,0
1381,F,13550,13140,410,"00,03",1,4
1382,L,5050,4690,360,"00,07",5,6
1383,A,9180,9180,0,"00,00",7,5
1384,D,14890,14740,150,"00,01",9,8
1385,J,1600,1550,50,"00,03",6,1
1386,C,8170,8170,0,"00,00",1,6
1387,J,7690,7300,390,"00,05",9,5
1388,K,3670,3550,120,"00,03",9,9
1389,D,12560,12050,510,"00,04",10,6
1390,F,12170,11310,860,"00,07",8,10
1391,J,2550,2470,80,"00,03",8,2
1392,A,9350,9350,0,"00,00",5,1
1393,D,14420,13690,730,"00,05",9,3
1394,L,250,240,10,"00,04",1,10
1395,J,310,300,10,"00,03",3,1
1396,J,2700,2610,90,"00,03",10,9
1397,D,14020,13590,430,"00,03",6,1
1398,D,8260,8090,170,"00,02",9,3
1399,L,320,310,10,"00,03",1,3
1400,J,4560,4420,140,"00,03",7,6
1401,L,2480,2400,80,"00,03",1,7
1402,A,11030,11030,0,"00,00",2,1
1403,E,14200,13200,1000,"00,07",10,10
1404,A,12460,12460,0,"00,00",10,5
1405,E,10340,10130,210,"00,02",9,9
1406,L,5040,4930,110,"00,02",3,8
1407,D,11100,10980,120,"00,01",9,5
1408,L,3980,3820,160,"00,04",4,6
1409,G,3700,3700,0,"00,00",9,2
1410,G,1820,1820,0,"00,00",8,2
1411,J,630,620,10,"00,02",2,1
1412,I,1950,1950,0,"00,00",5,10
1413,E,14140,13430,710,"00,05",7,7
1414,E,8120,7710,410,"00,05",2,2
1415,K,7190,6900,290,"00,04",7,7
1416,F,13380,12710,670,"00,05",1,10
1417,A,10720,10720,0,"00,00",6,4
1418,G,6430,6430,0,"00,00",5,3
1419,L,7280,6980,300,"00,04",2,4
1420,J,3760,3720,40,"00,01",10,7
1421,J,4970,4870,100,"00,02",9,2
1422,G,2470,2470,0,"00,00",9,0
1423,A,8690,8690,0,"00,00",10,8
1424,F,11130,10680,450,"00,04",4,7
1425,J,5430,5260,170,"00,03",8,5
1426,L,6650,6380,270,"00,04",2,5
1427,I,3380,3380,0,"00,00",3,9
1428,L,3700,3510,190,"00,05",4,5
1429,J,4820,4530,290,"00,06",6,4
1430,F,9790,9590,200,"00,02",5,6
1431,C,12690,12690,0,"00,00",4,8
1432,C,8500,8500,0,"00,00",6,10
1433,L,4170,4080,90,"00,02",2,8
1434,J,4860,4660,200,"00,04",9,6
1435,B,9950,9950,0,"00,00",2,2
1436,D,14300,13290,1010,"00,07",9,8
1437,C,14730,14730,0,"00,00",3,7
1438,L,320,310,10,"00,03",2,4
1439,F,12600,12470,130,"00,01",1,6
1440,J,4070,3980,90,"00,02",4,3
1441,J,4070,3860,210,"00,05",10,2
1442,G,1030,1030,0,"00,00",3,2
1443,G,7250,7250,0,"00,00",3,1
1444,J,3260,3160,100,"00,03",9,7
1445,F,14470,14030,440,"00,03",1,6
1446,D,8510,7910,600,"00,07",5,0
1447,J,3670,3520,150,"00,04",6,0
1448,L,5050,4890,160,"00,03",7,8
1449,F,15430,14650,780,"00,05",1,6
1450,C,9760,9760,0,"00,00",4,9
1451,D,9630,9050,580,"00,06",6,1
1452,D,15050,14290,760,"00,05",5,0
1453,D,14380,13370,1010,"00,07",5,0
1454,F,9430,8860,570,"00,06",1,10
1455,J,2120,2090,30,"00,01",9,2
1456,F,8450,8020,430,"00,05",5,9
1457,D,15230,14160,1070,"00,07",9,5
1458,J,6320,6250,70,"00,01",10,8
1459,J,3670,3520,150,"00,04",5,4
1460,L,4490,4260,230,"00,05",7,9
1461,F,12700,12190,510,"00,04",3,7
1462,D,10340,9920,420,"00,04",10,0
1463,F,13220,13080,140,"00,01",5,8
1464,L,3270,3230,40,"00,01",7,8
1465,F,13050,12390,660,"00,05",5,7
1466,J,2800,2740,60,"00,02",8,3
1467,F,15910,14790,1120,"00,07",1,8
1468,J,5300,5240,60,"00,01",4,2
1469,J,5610,5550,60,"00,01",10,1
1470,L,780,770,10,"00,01",1,9
1471,A,8390,8390,0,"00,00",8,2
1472,L,6760,6550,210,"00,03",4,10
1473,D,7750,7590,160,"00,02",10,0
1474,K,3650,3540,110,"00,03",3,3
1475,L,360,340,20,"00,06",1,6
1476,F,11220,10540,680,"00,06",4,10
1477,D,9590,9300,290,"00,03",7,5
1478,D,13460,12510,950,"00,07",4,0
1479,D,13280,12740,540,"00,04",10,5
1480,I,5280,5280,0,"00,00",8,9
1481,D,15260,14190,1070,"00,07",4,3
1482,F,15360,14430,930,"00,06",8,9
1483,J,650,640,10,"00,02",1,0
1484,D,11920,11320,600,"00,05",9,4
1485,K,1010,990,20,"00,02",2,2
1486,D,14160,13160,1000,"00,07",7,0
1487,J,4380,4200,180,"00,04",7,2
1488,D,8490,8310,180,"00,02",7,2
1489,J,980,970,10,"00,01",3,0
1490,L,4220,4130,90,"00,02",4,6
1491,C,11140,11140,0,"00,00",7,10
1492,L,6420,5970,450,"00,07",7,10
1493,F,11270,10700,570,"00,05",2,7
1494,D,9560,8980,580,"00,06",4,0
1495,F,11900,11780,120,"00,01",5,6
1496,J,4460,4410,50,"00,01",8,2
1497,J,3670,3550,120,"00,03",7,5
1498,D,12560,11680,880,"00,07",4,1
1499,J,4890,4790,100,"00,02",8,0
1500,G,2050,2050,0,"00,00",7,1
1501,F,12510,12130,380,"00,03",5,6
1502,I,150,150,0,"00,00",1,2
1503,C,11210,11210,0,"00,00",1,9
1504,L,370,360,10,"00,03",1,2
1505,L,3700,3620,80,"00,02",8,10
1506,A,12560,12560,0,"00,00",10,5
1507,G,6820,6820,0,"00,00",8,5
1508,L,860,840,20,"00,02",1,5
1509,D,13440,12490,950,"00,07",7,5
1510,F,14410,13970,440,"00,03",4,6
1511,I,2510,2510,0,"00,00",4,7
1512,L,3390,3280,110,"00,03",5,10
1513,D,9400,9300,100,"00,01",10,9
1514,J,1660,1570,90,"00,05",5,3
1515,F,15540,14910,630,"00,04",6,9
1516,F,8870,8600,270,"00,03",5,10
1517,D,12860,12470,390,"00,03",6,4
1518,D,9870,9670,200,"00,02",5,2
1519,J,7280,7130,150,"00,02",3,1
1520,L,6630,6160,470,"00,07",5,8
1521,L,6900,6550,350,"00,05",3,10
1522,D,11740,11380,360,"00,03",4,2
1523,K,3180,3080,100,"00,03",8,8
1524,L,4570,4520,50,"00,01",4,8
1525,F,10080,9770,310,"00,03",2,6
1526,G,2000,2000,0,"00,00",10,2
1527,J,920,900,20,"00,02",3,1
1528,L,3080,2950,130,"00,04",4,6
1529,F,9790,9200,590,"00,06",5,8
1530,D,9760,9270,490,"00,05",5,4
1531,J,7240,6800,440,"00,06",9,3
1532,L,380,360,20,"00,05",1,8
1533,E,14070,13920,150,"00,01",1,1
1534,J,1070,1040,30,"00,03",8,5
1535,L,2530,2450,80,"00,03",2,9
1536,F,14820,14070,750,"00,05",3,7
1537,L,4420,4280,140,"00,03",8,10
1538,A,12110,12110,0,"00,00",8,6
1539,D,12320,11450,870,"00,07",8,6
1540,D,8420,7830,590,"00,07",7,1
1541,A,7820,7820,0,"00,00",4,0
1542,L,4340,4120,220,"00,05",6,8
1543,E,11430,10970,460,"00,04",8,8
1544,F,12700,12060,640,"00,05",5,6
1545,G,6200,6200,0,"00,00",10,2
1546,I,5300,5300,0,"00,00",1,5
1547,A,14330,14330,0,"00,00",5,2
1548,D,9540,9440,100,"00,01",7,0
1549,L,580,560,20,"00,03",1,4
1550,G,5280,5280,0,"00,00",5,1
1551,D,8760,8670,90,"00,01",10,4
1552,D,10760,10220,540,"00,05",3,1
1553,L,410,390,20,"00,05",2,3
1554,J,7660,7120,540,"00,07",10,6
1555,E,11300,10960,340,"00,03",9,9
1556,J,2480,2400,80,"00,03",9,3
1557,J,6880,6670,210,"00,03",9,6
1558,L,3270,3230,40,"00,01",7,8
1559,L,5300,5240,60,"00,01",4,6
1560,H,5310,5310,0,"00,00",4,4
1561,L,920,900,20,"00,02",2,6
1562,A,13830,13830,0,"00,00",7,2
1563,D,13520,12700,820,"00,06",10,8
1564,E,10380,9960,420,"00,04",10,10
1565,F,14000,13710,290,"00,02",5,7
1566,F,7870,7630,240,"00,03",8,10
1567,F,9050,8950,100,"00,01",1,3
1568,L,3060,3020,40,"00,01",2,4
1569,F,10730,10190,540,"00,05",1,2
1570,K,6880,6670,210,"00,03",4,4
1571,L,2950,2830,120,"00,04",4,5
1572,F,14970,14520,450,"00,03",5,8
1573,F,15100,14040,1060,"00,07",2,6
1574,D,12830,12700,130,"00,01",10,2
1575,C,9850,9850,0,"00,00",5,9
1576,J,2710,2680,30,"00,01",8,4
1577,B,12610,12610,0,"00,00",1,1
1578,D,11510,10700,810,"00,07",4,1
1579,D,15060,14000,1060,"00,07",4,3
1580,G,6990,6990,0,"00,00",4,3
1581,D,13060,12920,140,"00,01",2,1
1582,L,3640,3600,40,"00,01",2,4
1583,D,10550,10330,220,"00,02",5,0
1584,K,1200,1160,40,"00,03",7,7
1585,F,8550,8460,90,"00,01",1,3
1586,G,2750,2750,0,"00,00",5,1
1587,D,13310,13170,140,"00,01",3,0
1588,F,8520,8170,350,"00,04",4,10
1589,F,10230,9920,310,"00,03",6,10
1590,L,5690,5630,60,"00,01",4,9
1591,D,11510,10930,580,"00,05",5,4
1592,A,12920,12920,0,"00,00",8,5
1593,J,690,680,10,"00,01",2,1
1594,L,690,680,10,"00,01",2,8
1595,D,10110,9500,610,"00,06",10,2
1596,F,11730,11370,360,"00,03",4,5
1597,F,9150,8870,280,"00,03",3,6
1598,F,14020,13730,290,"00,02",1,10
1599,L,920,910,10,"00,01",1,7
1600,F,8440,8180,260,"00,03",4,6
1601,D,15740,14950,790,"00,05",8,3
1602,E,11130,10900,230,"00,02",9,9
1603,L,1930,1910,20,"00,01",1,2
1604,J,2930,2840,90,"00,03",9,5
1605,J,5060,4900,160,"00,03",3,2
1606,J,5860,5800,60,"00,01",6,0
1607,D,14540,13660,880,"00,06",9,7
1608,L,4910,4860,50,"00,01",2,5
1609,K,980,960,20,"00,02",1,1
1610,F,8910,8730,180,"00,02",2,5
1611,K,4500,4450,50,"00,01",2,2
1612,A,9470,9470,0,"00,00",6,2
1613,L,360,340,20,"00,06",1,4
1614,I,1510,1510,0,"00,00",7,8
1615,D,9990,9780,210,"00,02",5,4
1616,L,4560,4370,190,"00,04",7,8
1617,L,6450,6250,200,"00,03",2,3
1618,L,300,290,10,"00,03",2,10
1619,D,15250,14330,920,"00,06",6,2
1620,D,14850,14700,150,"00,01",7,2
1621,D,14180,13890,290,"00,02",10,3
1622,J,3910,3790,120,"00,03",8,2
1623,J,3090,2990,100,"00,03",5,1
1624,D,14270,13980,290,"00,02",6,2
1625,L,5900,5540,360,"00,06",9,10
1626,J,540,530,10,"00,02",1,0
1627,K,600,580,20,"00,03",1,1
1628,K,5270,4950,320,"00,06",3,3
1629,J,4710,4520,190,"00,04",10,6
1630,D,9120,8480,640,"00,07",9,8
1631,L,1430,1410,20,"00,01",1,3
1632,F,10470,10260,210,"00,02",6,7
1633,D,11660,11540,120,"00,01",9,7
1634,L,3420,3280,140,"00,04",4,10
1635,D,14840,14690,150,"00,01",3,1
1636,J,7620,7460,160,"00,02",3,2
1637,A,13100,13100,0,"00,00",10,9
1638,J,7880,7480,400,"00,05",7,3
1639,F,15180,14570,610,"00,04",3,4
1640,D,14280,13560,720,"00,05",3,2
1641,J,1020,1000,20,"00,02",2,0
1642,J,4490,4260,230,"00,05",3,2
1643,A,8560,8560,0,"00,00",10,6
1644,F,11900,11660,240,"00,02",2,9
1645,D,12560,12430,130,"00,01",6,0
1646,G,2040,2040,0,"00,00",1,0
1647,D,13920,13220,700,"00,05",3,0
1648,A,8190,8190,0,"00,00",10,0
1649,C,10890,10890,0,"00,00",3,8
1650,F,15010,13950,1060,"00,07",1,8
1651,D,13010,12480,530,"00,04",7,1
1652,F,9490,8920,570,"00,06",3,5
1653,J,7460,7230,230,"00,03",10,2
1654,D,14640,14490,150,"00,01",5,1
1655,F,8160,7830,330,"00,04",5,9
1656,F,10750,10210,540,"00,05",2,10
1657,F,13770,13490,280,"00,02",1,10
1658,J,1730,1660,70,"00,04",5,3
1659,D,11800,11560,240,"00,02",10,5
1660,I,2380,2380,0,"00,00",3,10
1661,F,13080,12550,530,"00,04",1,9
1662,J,3130,3030,100,"00,03",9,0
1663,F,10930,10710,220,"00,02",4,6
1664,J,6700,6490,210,"00,03",5,1
1665,J,3700,3620,80,"00,02",5,4
1666,F,14350,13630,720,"00,05",1,4
1667,K,7680,7370,310,"00,04",3,3
1668,K,500,490,10,"00,02",2,2
1669,D,9010,8460,550,"00,06",5,4
1670,F,9770,9670,100,"00,01",2,10
1671,F,7980,7580,400,"00,05",5,10
1672,D,8910,8820,90,"00,01",10,3
1673,A,9550,9550,0,"00,00",8,7
1674,J,790,780,10,"00,01",3,2
1675,H,5800,5800,0,"00,00",7,7
1676,J,4280,4100,180,"00,04",8,6
1677,A,7900,7900,0,"00,00",7,0
1678,E,14090,13800,290,"00,02",1,1
1679,Z,0,0,0,"00,00",0,2
1680,I,1690,1690,0,"00,00",1,7
1681,J,7640,7330,310,"00,04",4,1
1682,F,11970,11840,130,"00,01",4,5
1683,G,2500,2500,0,"00,00",10,8
1684,E,11340,11220,120,"00,01",5,5
1685,J,3120,2990,130,"00,04",2,0
1686,J,3480,3370,110,"00,03",10,8
1687,D,8950,8320,630,"00,07",3,2
1688,D,8780,8160,620,"00,07",3,2
1689,L,5770,5710,60,"00,01",2,6
1690,F,13680,12850,830,"00,06",4,9
1691,D,13650,12960,690,"00,05",10,0
1692,D,11100,10320,780,"00,07",5,1
1693,D,11600,11480,120,"00,01",9,2
1694,D,11540,11070,470,"00,04",10,8
1695,D,14200,13770,430,"00,03",5,0
1696,L,7650,7420,230,"00,03",3,7
1697,A,11600,11600,0,"00,00",8,4
1698,F,10530,9790,740,"00,07",4,6
1699,J,7400,7100,300,"00,04",6,2
1700,F,13050,12390,660,"00,05",2,7
1701,F,10030,9920,110,"00,01",5,6
1702,E,14890,14590,300,"00,02",6,6
1703,J,2820,2790,30,"00,01",7,3
1704,F,10480,9850,630,"00,06",1,10
1705,H,2640,2640,0,"00,00",4,4
1706,J,6250,6120,130,"00,02",9,1
1707,I,1260,1260,0,"00,00",5,9
1708,J,2110,2040,70,"00,03",10,2
1709,E,12380,12000,380,"00,03",10,10
1710,F,9790,9200,590,"00,06",6,7
1711,L,410,390,20,"00,05",3,8
1712,F,9250,8970,280,"00,03",1,3
1713,D,12220,11730,490,"00,04",4,1
1714,F,9250,8870,380,"00,04",4,8
1715,F,8130,7960,170,"00,02",1,9
1716,J,950,930,20,"00,02",3,0
1717,D,14890,13840,1050,"00,07",6,5
1718,A,14410,14410,0,"00,00",10,9
1719,D,9230,9040,190,"00,02",9,5
1720,J,5250,5140,110,"00,02",10,6
1721,L,4230,4140,90,"00,02",6,9
1722,L,610,590,20,"00,03",1,6
1723,D,10040,9830,210,"00,02",10,6
1724,F,9590,9110,480,"00,05",3,7
1725,L,7520,7360,160,"00,02",9,10
1726,J,3440,3300,140,"00,04",10,5
1727,D,13930,12950,980,"00,07",4,2
1728,L,2460,2410,50,"00,02",8,9
1729,A,8130,8130,0,"00,00",9,8
1730,J,5710,5360,350,"00,06",5,3
1731,F,15490,14400,1090,"00,07",6,8
1732,F,15090,14930,160,"00,01",3,9
1733,F,13460,13360,100,"00,01",2,3
1734,D,13230,12700,530,"00,04",5,4
1735,F,12950,12300,650,"00,05",2,4
1736,J,4820,4670,150,"00,03",10,4
1737,J,3160,3120,40,"00,01",10,4
1738,J,2050,1960,90,"00,04",8,4
1739,E,11410,10720,690,"00,06",2,2
1740,D,14840,14690,150,"00,01",10,9
1741,D,9370,8710,660,"00,07",10,1
1742,A,13900,13900,0,"00,00",10,6
1743,L,6400,6270,130,"00,02",3,6
1744,L,6490,6420,70,"00,01",3,6
1745,D,11390,11270,120,"00,01",8,4
1746,I,3530,3530,0,"00,00",2,6
1747,J,4530,4430,100,"00,02",8,3
1748,F,12470,12220,250,"00,02",4,5
1749,J,3790,3670,120,"00,03",9,6
1750,D,13700,13150,550,"00,04",7,5
1751,F,12210,11840,370,"00,03",3,9
1752,D,8470,7960,510,"00,06",9,1
1753,D,14890,14590,300,"00,02",4,2
1754,L,2700,2590,110,"00,04",5,7
1755,J,1880,1800,80,"00,04",5,1
1756,F,15290,14670,620,"00,04",1,3
1757,J,7460,7380,80,"00,01",8,6
1758,K,6440,6050,390,"00,06",8,8
1759,D,15130,14820,310,"00,02",8,6
1760,E,15260,14490,770,"00,05",6,6
1761,L,270,260,10,"00,04",2,8
1762,I,6320,6320,0,"00,00",1,2
1763,J,2950,2800,150,"00,05",10,9
1764,D,10270,9750,520,"00,05",6,1
1765,D,13710,13020,690,"00,05",5,0
1766,F,13220,12820,400,"00,03",6,7
1767,D,11370,10570,800,"00,07",8,1
1768,D,9560,9170,390,"00,04",10,0
1769,F,12120,11630,490,"00,04",7,9
1770,G,7440,7440,0,"00,00",7,1
1771,D,8300,8130,170,"00,02",9,5
1772,F,9730,9630,100,"00,01",8,9
1773,J,3230,3190,40,"00,01",4,3
1774,C,11950,11950,0,"00,00",1,3
1775,F,8870,8690,180,"00,02",2,6
1776,L,5420,5090,330,"00,06",1,8
1777,D,10830,10390,440,"00,04",5,3
1778,L,7830,7280,550,"00,07",2,4
1779,F,13470,12790,680,"00,05",9,10
1780,D,13650,12690,960,"00,07",8,1
1781,D,8210,7790,420,"00,05",2,0
1782,F,9420,9130,290,"00,03",1,2
1783,L,1500,1450,50,"00,03",5,6
1784,J,7310,7090,220,"00,03",10,4
1785,J,4040,3990,50,"00,01",10,8
1786,F,15930,14810,1120,"00,07",6,7
1787,D,9600,9500,100,"00,01",10,8
1788,F,12570,12310,260,"00,02",6,9
1789,I,150,150,0,"00,00",1,10
1790,L,1700,1680,20,"00,01",6,7
1791,J,1610,1540,70,"00,04",8,3
1792,L,4910,4610,300,"00,06",1,5
1793,J,6470,6340,130,"00,02",9,5
1794,D,13960,13120,840,"00,06",3,0
1795,F,8350,8180,170,"00,02",4,8
1796,J,4910,4560,350,"00,07",6,4
1797,F,14370,13930,440,"00,03",2,4
1798,K,980,950,30,"00,03",2,2
1799,L,3000,2870,130,"00,04",1,9
1800,I,2290,2290,0,"00,00",1,6
1801,F,14520,13640,880,"00,06",3,9
1802,J,5490,5320,170,"00,03",9,3
1803,J,3730,3650,80,"00,02",5,4
1804,A,10420,10420,0,"00,00",5,3
1805,D,11760,10930,830,"00,07",7,0
1806,I,5210,5210,0,"00,00",2,5
1807,D,10280,9760,520,"00,05",6,2
1808,F,10670,10450,220,"00,02",1,2
1809,L,300,290,10,"00,03",1,8
1810,J,3000,2900,100,"00,03",9,6
1811,K,2210,2140,70,"00,03",3,3
1812,J,2410,2360,50,"00,02",5,1
1813,F,8560,7960,600,"00,07",7,9
1814,D,8540,7940,600,"00,07",9,1
1815,F,10630,9880,750,"00,07",6,9
1816,I,100,100,0,"00,00",1,4
1817,D,10920,10700,220,"00,02",2,0
1818,J,7170,6810,360,"00,05",10,1
1819,F,10250,10040,210,"00,02",2,4
1820,J,2230,2160,70,"00,03",9,2
1821,I,4390,4390,0,"00,00",2,7
1822,L,900,890,10,"00,01",1,5
1823,J,6440,6110,330,"00,05",10,6
1824,D,15400,14780,620,"00,04",4,2
1825,G,7270,7270,0,"00,00",10,0
1826,K,5540,5480,60,"00,01",5,5
1827,J,4040,3950,90,"00,02",6,1
1828,F,10150,9940,210,"00,02",1,6
1829,J,310,300,10,"00,03",1,0
1830,D,9340,9150,190,"00,02",8,3
1831,F,14480,13610,870,"00,06",5,8
1832,D,11360,10560,800,"00,07",3,1
1833,K,6670,6260,410,"00,06",6,6
1834,D,7770,7610,160,"00,02",9,4
1835,L,3800,3680,120,"00,03",6,8
1836,D,9930,9630,300,"00,03",10,1
1837,L,1240,1220,20,"00,02",2,6
1838,D,14090,13100,990,"00,07",10,9
1839,A,14110,14110,0,"00,00",4,1
1840,F,13260,13120,140,"00,01",1,4
1841,L,340,330,10,"00,03",1,5
1842,D,10930,10380,550,"00,05",9,7
1843,L,5020,4710,310,"00,06",3,10
